C 0,0,150
SO     ./textures/seamless_stone.png
WE      ./textures/seamless_stone.png
EA       ./textures/seamless_stone.png
F 0,150,0
NO ./textures/seamless_stone.png



111111111111111111111111111111111111111111111111111111111111
10000000000000001000000000000000100000000000000000000001
1000000000000000D000000000000000100000000000000000000001
10000000000000001000000000000000100000000000000000000001
11111D11111111D11111111111111111111111100000000000000001
10000000001000000000000000000000000000D00000000000000001
100000000010000000000000N0000000000000100000000000000001
10000000001000000000000000000000000000100000000000000001
1111111111111111111111111111111111D111111111111111111111
10000000000000000000000000100000000000000010000000000001
10000000000000000000000100100000000000000010000000000001
10000000000000000000000000100000000000000010000000000001
10000000000000000000000000D000000000000000D0000000000001
10000000000000000000000000100000000000000010000000000001
10000000000000000000000000100000000000000010000000000001
10000000000000000000000000100000000000000010000000000001
11111111111111111111111111111111111111111111111111111111
                             1