SO     ./textures/zlij.png
WE      ./textures/zlij.png
EA       ./textures/zlij.png

NO ./textures/seamless_stone.png


F 220,100,0
C 225,30,0

1111111111111111111111111111111
1010000010000000000000000000001
1010101010111111100000000000001
1000111111000000000000000000001
1111101011111010111000000000001
1000001010001010000000000000001
1011111010111011111111111111111
1010000010101000001000000000001
1010111110101111101000000000001
1010100010101000101000000000001
1011101010101010100000000000101
1000001010100010100000000000001
1111111010111110111000000000001
1000001010001000100000000000001
1011101011101011101111111111111
1010001000001000101000000000001
1010111111111110101000000000001
100010000000000010001111111111
10101011101111111110111111111
1S10000010000000000011111111
111111111111111111111111111