SO     ./textures/the_starry_night.png
WE      ./textures/Mona_Lisa.png
EA       ./textures/girl_with_a_pearl_earring.png

NO ./textures/seamless_stone.png


F 220,100,0
C 225,30,0

111111111111111111111
101000001000000000001
1010101010111111100001
100010100010000010001
1111101011111010111001
100000101000101000001
1011111010111011111101
101000001010100000101
1010111110101111101001
101010001010100010101
1011101010101010101001
1000D0010101000101001
1111111010111110111001
100000101000100010001
1011101011101011101101
101000100000100010101
1010011111111111010101
100010000000000010001
101010111011111111101
1N1000001000000000001
111111111111111111111